############
#..........#
#..........#
#........&.#
#..........#
#.....##/###
#.....#...X#
#.....#$$$$#
############